######      # 
     # ###   
 ##  #      #
   # # ######
## #P  ##   ##
 #   ######   
 # #####    #
 #    ## ## #T
 #### ##     #
         ## ##