######      # 
     # ####  
 ##  #      #
   # # ######
## #P  ##   ##
 #   ######   
 # #####    #
 #    ## ## #T
 #### ##     #
         ## ##